000000000000000000000000000000000000000000000000000000000
000000000000000000000000000000000000000000000000000000000
000000000000000000000000000000000000000000000000000000000
000000000000000000000000000000000000000000000000000000000
000000000000000000000000000000000000000000000000000000000
000000000000000000000000000000000000000000000000000000000
000000000000000000000000007000000000000000000000000000000
000000000000000000000000000000000000000000000000000000000
000000000000222002000000222220022222002222200000000000000
000000000002000002000000200000020002002000200000000000000
000000000020000002000000200000020002002000200000000000000
000000000020000002000000200000020002002000200000000000000
000000000020000002000000200000020002002000200000000000000
000000000020000002000000200000020002002000200000000000000
000000000020000002000000200000020002002000200000000000000
000000000020000002000000222220022222002222200000000000000
000000000020000002000000200000020002002200000000000000000
000000000020000002000000200000020002002020000000000000000
000000000020000002000000200000020002002020000000000000000
000000000020000002000000200000020002002002000000000000000
000000000020000002000000200000020002002002000000000000000
000000000002000002000000200000020002002000200000000000000
000000000000222002222200222220020002002000200000000000000
000000000000000000000000000000000000000000000000000000000
000000000000000000000000000000000000000000000000000000000
000000000000000000000000000000000000000000000000000000000
000000000000000000000000000000000000000000000000000000000
000000000000000000000000000000000000000000000000000000000
000000000000000000000000000000000000000000000000000000000
000000000000000000000000000000000000000000000000000000000
000000000000000000000000000000000000000000000000000000000
222222222222222222222222222222222222222222222222222222222
