00000000000000000000000000000000000000000000000000000000
00000000000000000000000000000000000000000000000000000000
00000000000000000000000000000000000000000000000000000000
00000000000000000000000000000000000000000000000000000000
00000000000000000000000000000000000000000000000000000000
00000000000000000000000000000000000000000000000000000000
00000000000000000000000000000000000000000000000000000000
00000000000000000000000000000000000000000000000000000000
00000000000000000000000000000000000000000000000000000000
00000000000000000000000000000000000000000000000000000000
00000000000000000000000000000000000000000000000000000000
00000000000000000000000000000000000000000000000000000000
00000000000000000000000000000000000000000000000000000000
00000000000000000000000000000000000000000000000000000000
00000000000000000000000000000000000000000000000113000000
00000000000000000000000000000000000000000000000113000000
00000000000000000000000000000000000000000011000000000000
00000000000000000000000000000000000031100011000000000000
00000000000000000000000000000000000031100011000000000500
00000000000000000000000000000000001031100011000000000500
07700000000000000000000000000000001011100011333330001100           
07700000000000000000000000000000111011100011333330001100          
11100000000000000003330000000000111011100000000000000000
11111331111111111111188111111111111111100000000000000000
11118111111111111111818811111111111111100000044000000000
11111811111111111111111111111111111111100000044000000000
11111188111111111111111111111111111111111111111100000000
11188888111111111111111111111111111111111111111100000000
11111111181818811111111111111111111111118811111100000000
11111111111118881111111111111111111111111111111800000000
11111111111111111111111111111111111111111111111100000000

