00000000000000000000000000000000000000000000000000000000
00000000000000000000000000000000000000000000000000000000
00000000000000000000000000000000000000000000000000000000
00000000000000000000000000000000000000000000000000000000
00000000000000000000000000000000000000000000000000000000
00000000000000000000000000000000000000000000000000000000
00000000000000000000000000000000000000000000000000000000
00000000000000000000000000000000000000000000000000000000
00000000000000000000000000000000000000000000000000000000
00000000000000000000000000000000000000000000000000000000
00000000000000000000000000000000000000000000000000000000
00000000000000000000000000000000000000000000000000000000
00000000000000000000000000000000000000000000000000000000
00000000000000000000000000000000000000000000000000000000
00000000000000000000000000000000000000000000000113000000
00000000000000000000000000000000000000000000000993000000
00000000000000000000000000000000000000000011000000000000
00000000000000000000000000000000000031100099000000000000
00000000000000000000000000000000000039900099000000000500
00000000000000000000000000000000001039900099000000000000
07000000000000000000000000000000001019900099333330001100           
00000000000000000000000000000000111099900099333330009900          
11100000000000000003330000000000999099900000000000000000
99911331111111111111188111111111999199900000000000000000
99998999999999999999898899999999999999900000040000000000
99999899999999999999999999999999999999900000000000000000
99999988999999999999999999999999999999999999999900000000
99988888999999999999999999999999999999999999999900000000
99999999989898899999999999999999999999998899999900000000
99999999999998889999999999999999999999999999999800000000
99999999999999999999999999999999999999999999999900000000