00000000000000000000000000000000000000000000000000000000
00000000000000000000000000000000000000000000000000000000
00000000000000000000000000000000000000000000000000000000
00000000000000000000000000000000000000000000000000000000
00000000000000000000000000000000000000000000000000000000
00000000000000000000000000000000000000000000000000000000
00000000000000000000000000000000000000000000000000000000
00000000000000000000000000000000000000000000000000000000
00000000000000000000000000000000000000000000000000000000
00000000000000000000000000000000000000000000000000000000
00000000000000000000000000000000000000000000000000000000
00000000000000000000000000000000000000000000000000000000
00000000000000000000000000000000000000000000000000000000
00000000000000000000000000000000000000000000000000000000
00000000000000000000000000000000000000000000000000000000
00000000000000000000000000000000000000000000000000000000
00000000000000000000000000000000000022220000000000000000
00000000000000000000000000000000000000002200000000000000
00000000000000000000000000000000200000000000000000000000
00000000000000000000000000000000000000000000000000000000
00000000000000000000000000000200000000000000000000000000
70000000000000000000006000000000000000000000000000000000
00000000000000000000006000000000000000003333300002222222
11111111113311111111111111111111111111110000000002222222
99999999999999999999999999999999999999990000000000000022
99888999999999999999999999999888999999999000000000000022
99999888999999988888899999999988999999999890000000000022
99999999999999999999999999999999999999999888000000005022
99999999999988888888888999999999999999888898880000005022
99988999999999999999988899999999999999999999999999999999
99988999999999999999999999999999998899988999999999999999
99999999999999999999999999999999999999999999999999999999