00000000000000000000000000000000000000000000000000000000
00000000000000000000000000000000000000000000000000000000
00000000000000000000000000000000000000000000000000000000
00000000000000000000000000000000000000000000000000000000
00000000000000000000000000000000000000000000000000000000
00000000000000000000000000000000000000000000000000000000
00000000000000000000000000000000000000000000000000000000
00000000000000000000000000000000000000000000000000000000
00000000000000000000000000000000000000000000000000000000
00000000000000000000000000000000000000000000000000000000
00000000000000000000000000000000000000000000000000000000
00000000000000000000000000000000000000000000000000000000
00000000000000000000330000000000000000000000000000000000
00000000000000000000000000000000000000000000000000000000
00000000000000000000000000000000000000333000000000000022
00000000000000000000000000000000000222222222222200000022
00000000000000000000000000000001000220000000000000000022
00000000000000000000220000000000000##0000000000000000022
00000000000000002330000000#20000000220000000000000000022
00000000000000000000000000##00000002200002222222#22#2222
000000000000002200000000002#0000000220000000000000000000
00000000000000000000000000220000000#20000000000000000000
700000000022440000000000002200000002#0000000000000005000
00000000002244000000000000220000000223330000000000005000    
2222222222222###2222222222222222222222222222222222222222
2222222222222222222222222222222222222###2222222222222222
222222222222222222222222222222222222###22222222222222222
222222222222222#22222222222222222222222222222222##222222
2222222222222#2222222222222222222222222222222222##222222
22222222222222##22222222222222222222222222222222#2222222
22222222222222222222222222222222222###222222222222222222